Apfelkuchen:        Apple pie.
Baeckerei:          Bakery.
Berlin:             Capital of Germany.
Biergarten:         Beer garden.
BMW:                Bayerische Motoren Werke Aktiengesellschaft, a German 
                    car company.
Brot:               Bread.
Bratwurst:          A traditional german sausage.
Dirndel:            Dirndl, or traditional German feminine clothing.
Doener:             Roasted meat on a stick.
Schloss Eltz:       A castle in Germany owned by a branch of the German 
                    family, the House of Eltz
Flughafen:          Airport.
Gebaeck:            Pastries.
Hauptstrasse:       High street, or main street.
Hund:               Dog.
Klimaanlage:        Air conditioner.
Lederhose:          Leather pants.
Mehlhase:           Flour Bunny.
Porsche:            Offerings, or car brand named after creators Ferdinand
                    and Ferry Porsche.
Raesfeld:           Municipality in the South of Germany.
Rammstein:          Ramming stone, or the popular rock band.
Ratskeller:         Basement tavern.
Schloss:            Lock, depending on context, or castle
Schloss:            Castle, depending on context.
wettbewerbsfaehig:  Competitive.
Frau	            Woman
eingef√ºhrt          Introduced
Essen               Food
